0 3 8 5 4 3 3 7 3 2 0
8 1 3 7 4 2 5 1 3 7 2
2 6 2 5 3 7 2 5 8 2 6
6 1 7 3 6 1 2 4 4 7 8
2 6 1 2 7 1 2 6 1 3 1
2 3 3 6 1 4 4 3 8 6 3
10 4 7 3 7 6 8 1 7 7 1
3 8 2 5 3 5 7 3 8 9 3
1 3 5 5 4 5 3 8 1 3 7
2 6 5 1 6 8 2 8 1 7 7
0 8 4 3 5 1 6 4 3 2 0